##############
#S    #      #
# ## ### ### #
#  #     # # #
### #### # # #
#      # #   #
# #### ### ###
# #  #     # #
# # ###### #E#
##############