##############
#S    #      #
# ## ### ### #
#  #       # #
### #### # # #
#      # #   #
# #### ### ###
# #  #     # #
# # ######  E#
##############